भारत: भारत
का: क 
एक: एक
केंद्र: केंद्र
शासित: शासित
प्रदेश: प्रदेश
और: और
महानगर: महानगर
है: है
इसमें: इसम 
नई: नई
दिल्ली: दिल्ल 
सम्मिलित: सम्मिलित
जो: ज 
की: क 
राजधानी: राजधान राजधा 
होने: हो होन 
के: क 
नाते: ना नात न 
सरकार: सरकार
तीनों: तीन 
इकाइयों: इक इकाइय 
कार्यपालिका: कार्यपालिक 
संसद: संसद
न्यायपालिका: न्यायपालिक 
मुख्यालय: मुख्यालय
में: म 
स्थापित: स्थापित
हैं: हैं
वर्ग: वर्ग
किलोमीटर: किलोमीटर
फैला: फैल 
जनसंख्या: जनसंख्य 
तौर: तौर
पर: पर
दूसरा: दूसर 
सबसे: सबस 
बड़ा: बड़ 
यहाँ: यह 
लगभग: लगभग
करोड़: करोड़
लाख: लाख
बोली: बोल 
जाने: ज जान जा 
वाली: वाल 
मुख्य: मुख्य
भाषाएँ: भाषाएँ
हिन्दी: हिन्द 
पंजाबी: पंजाब 
उर्दू: उर्द 
अंग्रेज़ी: अंग्रेज़ 
ऐतिहासिक: ऐतिहासिक
महत्त्व: महत्त्व
इसके: इसक 
दक्षिण: दक्षिण
पश्चिम: पश्चिम
अरावली: अरावल 
पहाड़ियां: पहाड़ पहाड़िय 
पूर्व: पूर्व
यमुना: यमु यमुन 
नदी: नद 
जिसके: जिसक 
किनारे: किनार 
यह: यह
बसा: बस 
प्राचीन: प्राचीन
समय: समय
गंगा: गंग 
मैदान: मैदान
से: स 
होकर: हो 
वाले: वाल 
वाणिज्य: वाणिज्य
पथों: पथ 
रास्ते: रास् रास्त 
पड़ने: पड़ पड़न 
वाला: वाल 
पड़ाव: पड़ाव
था: थ 
: 
